NO ./bonus/assets/colorstone.xpm
SO ./bonus/assets/eagle.xpm
WE ./bonus/assets/mossy.xpm
EA ./bonus/assets/greystone.xpm
D ./bonus/assets/door.xpm
F 105,105,105
C 25,25,112

1111111111111  1111111111111111111
1000000000001111001001001001001001
1000111111000D00000000000000000001
1000000000001111000000011000000001
100000S000001  1000000011000000001
1000000000001  1000000000000000001
1111110111111  1001001001001001001
     101       1111111111011111111
     1D1                1D1
     101                101
1111110111111          10001
1000000000001         1000001
1000000000001        100000001
1000100010001       10000000001
1000000000001        100000001
1000100010001         1000001
1000000000001          10001
1111110111111           101
     1D1                1D1
     1011111111111111111101
     1000000000000000000001
     1111111111111111111111
